0 0 0 0 0 0 d d d 0 0 0 0 0 0 0 0 0 0 0
0 a a a 0 0 d d d 0 0 0 0 0 0 0 0 0 0 0
0 a a a 0 0 d d d 0 0 0 0 0 0 0 0 0 0 0
0 a a a 0 0 d d d x x 0 0 0 0 0 0 0 0 0
0 0 a 0 0 0 0 d 0 0 x 0 0 0 0 0 0 0 0 0
0 b b b b b 0 y y 0 x 0 0 0 0 0 0 0 0 0
0 b b b b b 0 y y 0 x 0 0 0 0 0 0 0 0 0
b b b b b b b y y 0 x 0 0 0 0 0 0 0 0 0
0 b b b b b 0 y y 0 x 0 0 0 0 0 0 0 0 0
0 b b b b b 0 y y 0 x 0 w w w w w w w 0
0 0 b 0 0 0 0 y 0 0 x w w w w w w w w 0
0 c c c 0 0 z z z 0 x 0 w w w w w w w 0
0 c c c 0 0 z z z 0 x 0 0 w 0 0 0 0 0 0
0 c c c 0 0 z z z 0 x 0 x x x x x x x 0
0 0 0 0 0 0 z z z 0 x x x x x x x x x e
0 0 0 0 0 0 0 0 0 0 0 0 x x x x x x x 0